-------------------------------------------------
-------------------------------------------------
-------------------------------------------------
-------------------------------------------------
-------------------------------------------------
-------SSSSSSSSSS----SSSS------------------XX----
------------------------------------------XXX----
-----------------------------------------XXXX----
----------------------------------------XXXXX----
----------------------------------------XXXXX----
--------------------------------------XXXXXXX----
-------------------------------------XXXXXXXX----
----------------------------------------XXXXX----
----XXXXX---------XXXXX----------X-XXXXXXXXXXXXXX
  