-------------------------
-------------------------
------?------------------
-------------------------
-------------------------
-------------------------
--------SS---------------
-------------------------
SSSSSS------X------------
-----------XX------------
----------XXX------------
---------XXXX------------
--------XXXXX---XX----X--
XXXXXXX-XXXXXXXXXXXXXXXXX