-------------------------
-------------------------
-------------------------
-------------------------
-------------------------
------------------------?
-------------------------
-------------------------
---------------oo--------
-------X-------------E--Q
------XX------------<>---
-----XXX------------[]---
---XXXXX------------[]---
XXXXXXXXXXXXX-----XXXXXXX