-------------------------
-------------------------
-------------------------
-------------------------
-------------------------
----E--------------------
---<>--------------------
---[]--------------------
---[]---------------E----
--SXXS-------------<>----
-------------------[]----
-------------------[]----
----------X--------[]----
XXXXXXXXXXXXXXXXXXXXXXXXX