-------------------------
-------------------------
-------------------------
-------------------------
-------------------------
-----S-----------E-------
-------------------------
-------------------XSS--o
-----------------EXXX----
--QQQQQ---------<>XXX-SS-
----------------[]XXX----
---------------X[]XXX--SS
--------------XX[]XXX----
XXXXXXXXXXXXXXXXXXXX-----