-------------------------
-------------------------
-------------------------
-------------------------
-------------------------
----------SSSSSS---------
---oo--------------------
-------------------------
-E-----SSS---------------
<>-----------------------
[]-----------------------
[]-----------------------
[]------------------E----
XXXXXXXXXXX------XXXXXXXX