-------------------------
-------------------------
-------------------------
-------------------------
-------------------------
------------------------X
------------------------X
------------------------X
------------------------X
------------------------X
--------------------E---X
-------------------------
-EE-EE-E-EE-E------------
XXXXXXXXXXXXXXXXXXXXXXXXX