-------------------------
-------------------------
-------------------------
-------------------------
-------------------------
-------------------------
-------ooo---------------
-------------------------
-------------------------
-------------------------
-----X-------------------
-----X-------------------
-----X------------EE-E---
XXXXXXXXXXXX--XXXXXXXXXX-