-------------------------
-------------------------
----------------?--------
-------------------------
-------------------------
-------------------------
------------------SS----X
-----------------------XX
-------------SSS------XXX
--Q-E----------------XXXX
----E---------------XXXXX
-------------------XXXXXX
------------------XXXXXXX
XXXXXXXXXXXXXXXXX-XXXXXXX