-------------------------
-------------------------
-------------------------
-------------------------
-------------------------
-------------------------
-------------------------
-------------------------
----------o--------------
-------------------------
-------------------------
---------------B-----<>-X
EE-------------b-----[]XX
XXXX-X-XXXXXXXXXXXXXXXXXX