-------------------------
-------------------------
-----------------------?-
-------------------------
-------------------------
-------------------------
-------------------------
----------X--------------
----------X---------SSS--
--------X-X--------------
--------X-X------E-------
--------X-X--------------
-EE-----X-X--------------
XXXXX---X-X----XXXXXXXXX-