-------------------------
-------------------------
-------------------------
-------------------------
-------------------------
-------------------------
-------------------------
-------------------------
-Q-----------------------
E------------------------
E------------------------
-------------------------
------XXXX---------------
XXXXXXXXXXXXXX-XXXXXXXXXX