-------------------------
-------------------------
-------------------------
-------------------------
-------------------------
-------------------------
-------------------------
-------------------------
---------------------oo--
------------------X------
------------------X------
-B----------------X------
-b----------------X------
XXXXXXXXXXXXX-----X-----X