-------------------------
-------------------------
-------------------------
-------------------------
-------------------------
-------------------------
-------------------------
-------X-----------------
------XX-----------------
-----XXX-----------------
----XXXX-----------------
---XXXXX------<>---------
--XXXXXX------[]---------
XXXXXXXXXXXXXXXXXXXXXXXXX