-------------------------
-------------------------
-------------------------
-------------------------
-------------------------
-------------------------
-------------------------
-------------------------
-------------------------
--------------------E----
B----------------XX<>----
b---------------XXX[]----
---------------XXXX[]----
XXXXXXXXXXXXXXXXXX-XXXXXX