-------------------------
-------------------------
-------------------------
-------------------------
-------------------------
---------SSSSSSSSSSS-----
-----------------------E-
----------------------<>-
----------------------[]-
-------XX-------------XX-
-------XX----------------
-------XXX---------------
---EE--XXX---------------
XXXXXXXXXXXXXXXXX----XXXX