-------------------------
-------------------------
-------------------------
-------------------------
-------------------------
-------------------------
-------------------------
-------------------------
--------------------oo---
-------------------------
---------E---------------
--------<>---------------
--------[]----E----------
XXXXXXXXXXXXXXXXXXX------