-------------------------
-------------------------
-------------------------
-------------------------
-------------------------
-----------------SSSSSS--
-------------------------
-------------------------
-------------------------
-------------------------
-------------------------
---X---------------------
---X------EE-------------
XXXXXXXXXXXXXXXXXXX-----X