-------------------------
-------------------------
E------------------------
-------------------------
-------------------------
-------------------------
-------------------------
--------------------o----
---------------------E---
------------------SSSSS--
-------E----------E------
----------------------E--
XX-----------------------
XXXXX-X-XX----XXXXXXXXXXX