-------------------------
-------------------------
-------------------------
-------------------------
-------------------------
-------------------------
-------------------------
-------------------------
-------------o----oo-----
---------E---------------
--------<>---------------
--------[]---------------
EE---E--[]---------------
XXXXXXXXXXXX---X-----X---