-------------------------
-------------------------
-------------------------
-------------------------
-------------------------
-------------------------
-------------------------
-------------------------
-------------oo-----E----
-------------------<>----
-------------------[]----
-------------------[]----
----EE-------------[]-E-E
XXXXXXXX---X----X--XXXXXX