-------------------------
-------------------------
-------------------------
-------------------------
-------------------------
-----------------XX------
----------------XXX------
---------------XXXX------
--------------XXXXX---o--
-------------XXXXXX------
--B---------XXXXXXX------
--b--------XXXXXXXX------
--B-------XXXXXXXXX------
XXXXXXXXXXXXXXXXXXXXXXXXX