-------------------------
-------------------------
-------------------------
-------------------------
-------------------------
---------------------SSSS
-------------------------
-------------------------
----------------------E--
--------------------SSSSS
-------------------------
-------------------------
-E-E-E-E-EE--------------
XXXXXXXXXXXXXXXXX---XXXXX