-------------------------
-------------------------
-------------------------
-------------------------
-------------------------
-------------------------
-------------------------
-----XX-------------X----
----XXX-------------X----
---XXXX-----------X-X--X-
--XXXXX-----------X-X--X-
-XXXXXX-----------X-X--X-
XXXXXXX-----------X-X--X-
XXXXXX--X--XXXXX--X-X--X-