-------------------------
-------------------------
---------------------E---
-------------------------
-------------------------
------XXXX---------------
-----XXXXX---------------
----XXXXXX---------------
---XXXXXXX---------------
---XXXXXXX---------------
-XXXXXXXXX---------------
XXXXXXXXXX---------------
---XXXXXXX----E-E-E--XX--
XXXXXXXXXXXXXXXXXXXXXXXXX