-------------------------
-------------------------
-------------------------
-------------------------
-------------------------
-------------------------
-------------------------
-------------------------
-------------------------
-------------------oo----
-------------------------
----B--------------------
XX--b---E-E--------------
XXXXXXXXXXXXXXXXXXXXXXXXX