-------------------------
-------------------------
-------------------------
-------------------------
-------------------------
---------------XXXX------
--------------XXXXX------
---o---------XXXXXX------
----E-------XXXXXXX------
-SSSSS-----XXXXXXXX------
-E--------XXXXXXXXX---E--
-----E---XXXXXXXXXX------
--------XXXXXXXXXXX------
XXXXXXXXXXXXXXXXXXXXXXXXX