-------------------------
-------------------------
-------------------------
-------------------------
-------------------------
-------------------------
-------------------------
-------------------------
-------------------------
-------------------------
------------------------<
-----------X------------[
-E-EE-EE-E-X-----X------[
XXXXXXXXXXXXXXXXXXXXXXXXX