-------------------------
-------------------------
-------------------------
-------------------------
-------------------------
----------------SS-------
-------------------------
-------------------------
-E-----------------------
<>-------------XXXX------
[]----------XXXXX--------
[]---B---XXXXXX----------
[]---b--XXXXX------------
XXXXXXXXXXX------XX--XXXX