-------------------------
-------------------------
-------------------------
-------------------------
-------------------------
----------------SQQS--SSS
-------------------------
-------------------------
---E---------------------
--<>-------------SS--X---
--[]-----------------X---
--[]-----------------X---
--[]-EE-EE-----E-E---X---
XXXXXXXXXXXXXXXXXXXXXXXX-