-------------------------
-------------------------
-------------------------
-------------------------
-------------------------
-------------------------
-------------------------
----------------------X--
---------------------XX--
---------X----------XXX--
---------XX--------XXXX--
---------XXX------XXXXX--
---------XXXX----XXXXXX--
XXX--X-XXXXXXXXXXXXXXXXXX