-------------------------
-------------------------
-------------------------
-------------------------
-------------------------
---------------XXX---SSSS
--------------XXXX-------
-------------XXXXX-------
------------XXXXXX----E--
-E---------XXXXXXX--SSSSS
<>--------XXXXXXXX-------
[]-------XXXXXXXXX-------
[]-E----XXXXXXXXXX-------
XXXXXXXXXXXXXXXXXXXXXXXXX