-------------------------
-------------------------
-------------------------
-------------------------
-------------------------
--------------------SSS--
-------------------------
-------------------------
-------------------------
-------------------XXXXX-
-------------------X-----
-------------------X-----
--EE-E-E-EE-E-EE---X-----
XXXXXXXXXXXXXXXXXXXXXX---