-------------------------
-------------------------
-------------------------
-------------------------
-------------------------
-------------------------
----------E--------------
---------<>--------------
---------[]-------X------
---------[]------XX------
-------E-[]-----XXX------
------<>-[]----XXXX------
------[]-[]--XXXXXX------
XXXXXXXXXXXXXXXXXXXXXXXXX