-------------------------
-------------------------
-------------------------
-------------------------
--------------------oo---
--------XX---------------
-------XXX---------------
------EXXX---------------
-----XXXXX---------------
----XXXXXX---------------
---XXXXXXX---------------
--XXXXXXXX---------------
-XXXXXXXXX-----EE-E-EE---
XXXXXXXXXXXXXXXXXXXXXXXXX