-------------------------
-------------------------
-------------------------
---------------o---------
-------------------------
-------------SSS-----SSSS
-------------------------
-------------------------
----E--------------SS----
---<>---------S----------
---[]--E-----------------
---[]-<>-----------------
---[]-[]-------E---------
XXXXXXXXXXXXXXXXXXXXXX---