-------------------------
-------------------------
-------------------------
-------------------------
-------------------------
-------------------------
-------------------------
-------------------------
-----------------oo------
-E-------SSSS---o-----E--
<>-------------------<>--
[]-------------------[]--
[]-------------------[]--
XX---XXXXXXXXXXXXXXXXXX--