-------------------------
-------------------------
-------------------------
-------------------------
-------------------------
S-------XX---------------
--------XX---------------
-----XX-XX---------------
-----XX-XX---------------
S----XX-XX---------------
----XXX-XX---------------
----XXX-XX---------------
----XXX-XX------E--------
XXXXXXX-XXXXXXXXXXXXXXXXX