-------------------------
-------------------------
-------------------------
-------------------------
----E--------------------
---SQS-------------------
-------------------------
-------------------------
------------------XSS-SQ-
---SQS-----------XXX-----
----------------XXXX-----
---------------XXXXX-----
-------E------XXXXXX--SSS
XXXXXXXXXXXXXXXXXXX------