-------------------------
-------------------------
-------------------------
-------------------------
-------------------------
---------------------SSSS
-------------------------
-------------------------
------------oo--------E--
--------------------SSSSS
-------------------------
-------------------------
-------------------------
XXX---X--------X--XXXXXXX