-------------------------
-------------------------
-------------------------
-------------------------
-------------------------
------SSSSSSSSSSSSSS-----
-------------------------
-------------------------
-------------------------
-SSS---------------------
-------------------------
-------------------------
-----------------------EE
XXXXXXXXXXXXX--------XXXX