-------------------------
-------------------------
-------------------------
-------------------------
-------------------------
-----------SSSSS---------
-------------------------
-------------------------
---------SS--------------
-------------------------
--------------------E----
-------------------------
------X------------------
XXXXXXXXXXXX-----XXXXXXXX