-------------------------
-------------------------
-------------------------
-------------------------
-------------------------
-------------------------
-------------------------
-------------------------
-------------------------
----X------<>------E----<
---XX------[]-----<>----[
--XXX------[]-----[]----[
-XXXX------[]-----[]----[
XXXXXXXXXXXXXXXXXXXXXXXXX