-------------------------
-------------------------
-------------------------
-------------------------
-------------------------
------------------XX-----
------------------XX-----
------------------XX-----
---Q-----------XX-XX-----
Q-E-----------XXX-XX-----
--E----------XXXX-XX-----
------------XXXXX-XX-----
-----------XXXXXX-XX-----
XXXXXXXXXXXXXXXX--XXXXXXX