-------------------------
-------------------------
-------------------------
-------------------------
-------------------------
---S------------SS?SS?SSS
-------------------------
-------------------------
--E-EE-------------------
------XX-X-----SSSSSSSSSS
------XX-XX--------------
------XX-XXX-------------
------X--XXXX------------
------X--XXXXXXXXXXXXXXXX