-------------------------
-------------------------
-------------------------
-------------------------
-------------------------
-SSSSSS------------------
-------------------------
-------------------------
-------------S-----------
----------------E------X-
---------------<>-----XXX
---------------[]----XXXX
---------------[]---XXXX-
XXXXX---XXXXXXXXXXXXXXXX-