-------------------------
-------------------------
-------------------------
-------------------------
-------------------------
-------------------------
-------------------------
-------------------------
----------------oo-------
-QQQ---------------------
------------------------E
-E---------------------<>
-----------------------[]
XXXXXXXXX-XXX------XXXXXX