-------------------------
-------------------------
-------------------------
---------o---------------
-------------------------
-------SSS---------------
-------------------------
-------------------------
--------------E----------
--------S----<>----------
-------------[]----------
-------------[]----------
---------E---[]-EE-EE-E-E
XXXXXXXXXXXXXXXXXXXXXXXXX