-------------------------
-------------------------
-------------------------
-------------------------
-------------------------
------------------XX-----
------------------XX-----
------------------XX-----
---------------XX-XX-----
ESSS----------XXX-XX-----
-------------XXXX-XX-----
------------XXXXX-XX-----
----------XXXXXXX-XX-----
XXXXXXXXXXXXXXXX--XXXXXXX