-------------------------
-------------------------
-------------------------
-------------------------
-------------------------
-------------------------
-------------------------
-------------------------
--------oo---------------
--------------SSSS------X
-----------------------XX
-------------------<>-XXX
-------------------[]XXXX
XXXXXXXXXXXXXXXXXXXXXXXXX