-------------------------
-------------------------
---------------------?---
-------------------------
-------------------------
-------------------------
-----------------------SS
-----X-------------------
----XX--------SSSSSSS----
---XXX-------------------
--XXXX-------------------
-XXXXX------------------X
XXXXXX-----------------XX
XXXXXXXXXXXXXXXXXXXXXX-XX