-------------------------
-------------------------
-------------------------
-------------------------
-------------------------
--------------XX---------
--------------XX---------
--------------XX---------
-----------XX-XX-------?-
----------XXX-XX---------
---------XXXX-XX---------
--------XXXXX-XX---------
-E----XXXXXXX-XX---------
XXXXXXXXXXXX--XXXXXXXXXXX