-------------------------
-------------------------
-------------------------
-------------------------
-------------------------
-----------SSSSS--------S
-------------------------
--------E----------------
---oo--<>----------------
-------[]---S----X----XX-
-------[]-----E--X----XX-
-------[]--------X----XXX
-------[]--------X----XXX
-------XXXXXXXXXXXXX--XXX