-------------------------
-------------------------
-------------------------
-------------------------
-------------------------
-------------------------
-------------------------
-------------------------
---------------oo---E----
-------------------<>---<
-------------------[]---[
-------------------[]---[
-------------------[]---[
XXXXXXXXXXXXXXXXXXXXXXXXX