-------------------------
-------------------------
-------------------------
-------------------------
-------------------------
---------XX----------S---
--------XXX--------------
-------XXXX--------------
------XXXXX--------------
-----XXXXXX--------------
----XXXXXXX-----------E--
---XXXXXXXX-----B----<>--
XXXXXXXXXXX-----b----[]--
XXXXXXXXXXXXXXXXXXXXXXXXX