-------------------------
-------------------------
-------------------------
-------------------------
-------------------------
-------------------------
-------------------------
-------------------------
----------oo-------------
-------------------------
-------------------------
------------------E------
--E---E----------------XX
XXXXXXXX-----X--X-X-XXXXX