-------------------------
-------------------------
-------------------------
-------------------------
-------------------------
-------------Q-----------
-------------------------
-------------------------
----------------------o--
SS---------S?SQS---------
-------------------------
-------------------------
-------E----E------------
XXXXXXXXXXXXXXXXXXXX----X