-------------------------
-------------------------
-------------------------
-------------------------
-------------------------
-------------------------
-------------------------
-------------------------
-E-----------------------
<>-----------------------
[]-----------------------
[]-----<>----------------
[]-----[]----------------
XXXXXXXXXXX-XXXX-X--XXXXX