-------------------------
-------------------------
-------------------------
-------------------------
-------------------------
---------------XX--------
--------------XXX--------
-------------XXXX-------o
------------XXXXX--------
--X---------XXXXX-----SS-
--XX------XXXXXXX--------
--XXX----XXXXXXXX--------
--XXXX------XXXXX--------
XXXXXXXXXXXXXXXXXXXXXXXXX