-------------------------
-------------------------
-------------------------
-------------------------
-------------------------
-------SSSSS--------XX---
--------------------XX---
--------------------XX---
-------SSSSS--------XX---
Q-------------------XX---
--------------------XX---
-------------------------
E----------------E-------
XXXXXX------XXXXXXXXXXXXX