-------------------------
-------------------------
-------------------------
-------------------------
-------------------------
-------------------SSSSS-
-------------------------
------------------E------
-------------------------
----------------S?S------
------------E------------
-----------<>------------
--EE-------[]------------
XXXXXXXXXXXXXXXXXXXXX----