-------------------------
-------------------------
-------------------------
-------------------------
-------------------------
-------------------------
-------------------------
-------------------------
-------------------------
------------------XX-----
--------<>----E--XXX-----
--------[]------XXXX-----
---E----[]-E---XXXXX-----
X-XXXXXXXXXXXXXXXXXX-----