-------------------------
-------------------------
-------------------------
-------------------------
-------------------------
-------------------------
-------------------------
------------X------------
--o--------XX------------
----------XXX------------
--------EXXXX----E-------
--------XXXXX---<>-------
-------XXXXXX---[]-------
XXXXXXXXXXXXXXXXXXXXXXXXX