-------------------------
-------------------------
-------------------------
-------------------------
-------------------------
-------------------------
----------------E--------
---------------<>--------
---------------[]--------
---------------XX--------
-------------------------
------------E-----B------
------------------b------
--XXXXXXXXX-X-XXXXXXXXXXX