-------------------------
-------------------------
-------------------------
-------------------------
-------------------------
-----------S-------------
-------------------------
-------------------------
----------E-EE-----------
--------------XX-XX------
--------------XX-XX------
--------------XX-XX------
--------------X--XX-----X
XXX-XX--------X--XX--XXXX