-------------------------
-------------------------
-------------------------
-------------------------
-------------------------
-------------------------
-------------------------
-------------------------
-------------------------
-----------------X-------
----------------XXX------
-E----------<>-XXXX------
------------[]XXXX-------
-X-X-XXXXXXXXXXXXX---X---