-------------------------
-------------------------
-------------------------
-------------------------
-------------------------
-------------------------
-------------------------
-----------XSS--o--------
-o--------XXX-----------E
---------XXXX-SS-------<>
--------XXXXX----------[]
-------XXXXXX--SSS-----[]
------XXXXXXX----------[]
---XXXXXXXXX------XXX--XX