-------------------------
-------------------------
-------------------------
-------------------------
-------------------------
XX-----------------------
XX-----------------------
XX-------E---------------
XX------<>----oo---------
XX------[]---------------
XX------[]---------------
--------[]---------------
--------[]---------------
XXXXXXXXXXXXXXXXXXXXXXXXX