-------------------------
-------------------------
-------------------------
-------------------------
-------------------------
-------------------------
-------------------------
-------------------------
-------------------------
oo----------------------<
------------------------[
------------------------[
--------------E---------[
XXXXXXXXXXXXXXXXXXXXXXXXX