-------------------------
-------------------------
-------------------------
-------------------------
-------------------------
-------------------------
-------------------------
-----XX------------------
-----XX------------------
-----XX-----------------E
E---XXX----------------<>
----XXX----------------[]
----XXX----------------[]
XXXXXXX--XXXXXXXXXXXXXXXX