--------------------------
--------------------------
--------------------------
--------------------------
--------------------------
--------------------------
--------------------------
--------------------------
---------------------o----
SS-----E------------------
------<>---E--------------
------[]--<>-----E--------
------[]--[]--------------
XXXXXXXXXXXXXXXX-X-X---X--