--------------------------
--------------------------
--------------------------
--------------------------
--------------------------
-----------------SS-------
--------------------------
--------------------------
--------------------------
----------------XXXX------
-------------XXXXX-----E--
----------XXXXXX----------
---------XXXXX------------
--X-XXXXXXXX------XX--X-XX