-------------------------
-------------------------
-------------------------
-------------------------
-------------------------
---------------------XX--
--------------------XXX--
-------------------XXXX--
---Q--------------XXXXX--
Q-E--------------XXXXXX--
--E-------------XXXXXXX--
---------------XXXXXXXX--
--------------XXXXXXXXX--
XXXXXXXXXXXXXXXXXXXXXXXXX