-------------------------
-------------------------
-------------------------
-------------------------
-------------------------
---------------XXXX------
--------------XXXXX------
-------------XXXXXX------
------------XXXXXXX------
oo---------XXXXXXXX------
----------XXXXXXXXX---E--
---------XXXXXXXXXX------
--------XXXXXXXXXXX------
XXXXXXXXXXXXXXXXXXXXXXXXX