--------------------------
--------------------------
--------------------------
--------------------------
--------------------------
-----------------SSS------
--------------------------
--------------------------
--------------------------
--------------E-XXXXX-----
-------------<>-X---------
-------------[]-X---------
---EE--EE-E--[]-X---------
XXXXXXXXXXXXXXXXXXX----XXX