---------------------------
---------------------------
---------------------------
---------------------------
---------------------------
-----------SSSSSSSSSSS-----
-------------------------E-
------------------------<>-
------------------------[]-
---------XX-------------XX-
---------XX----------------
---------XXX---------------
------E--XXX---------------
XXXXXXXXXXXXXXXXXXX----XXXX