------------------------------
------------------------------
--------------?---------------
---------o--------------------
------------------------------
-------SSS-------------XXXX---
----------------SS----XXXXX---
---------------------XXXXXX---
------------SS------XXXXXXX---
--------S----------XXXXXXXX---
------------------XXXXXXXXX---
-----------------XXXXXXXXXX---
---------E------XXXXXXXXXXX---
XXXXXXXXXXXXXXX-XXXXXXXXXXXXXX