--------------------------
--------------------------
--------------------------
--------------------------
--------------------------
------------------SSSSSS--
--------------------------
--------------------------
------oo------------------
--------------------------
--------------------------
--------------------------
-----------EE-------------
XXXXXXXXXXXXXXXXXXXX-----X