--------------------------
--------------------------
--------------------------
--------------------------
--------------------------
-------SSSSSSSSSSSSSS-----
--------------------------
--------------------------
--------------------------
----E---------------------
---<>---------------------
---[]---------------------
---[]-------------------EE
XXXXXXXXXXXXXX--------XXXX