-------------------------
-------------------------
--------------------E----
-------------------------
-------------------------
-------------------------
-------------------------
-------------------------
---------E---------------
-----E--<>---------------
----<>--[]-------E-------
----[]--[]---------------
-X--[]--[]--E-------XX---
XXXXXXXXXXXXXXXXXXXXXXXXX