---------------------------
---------------------------
---------------------------
---------------------------
---------------------------
-----------XX----------S---
----------XXX--------------
---------XXXX--------------
--------XXXXX--------------
-------XXXXXX--------------
------XXXXXXX-----------E--
-----XXXXXXXX-----B----<>--
----XXXXXXXXX-----b----[]--
XXXXXXXXXXXXXXXXXXXXXXXXXXX