--------------------------
--------------------------
--------------------------
--------------------------
--------------------------
-SSS----------------------
--------------------------
-------------X------------
------------XX------------
-----------XXX------------
---------EXXXX----E-------
---------XXXXX---<>-------
--------XXXXXX---[]-------
XXXXXXXXXXXXXXXXXXXXXXXXXX