--------------------------
--------------------------
--------------------------
--------------------------
--------------------------
-----------------S--------
--------------------------
-------------X------------
-------------X--E-EE------
----------XX-X------XX-X--
----------XX-X------XX-X--
----------XX-X------XX-X--
EE--------XX-X------X--X--
XXXX-X-XXXXX-X------X--X--