--------------------------
--------------------------
--------------------------
--------------------------
--------------------------
---------------XX---------
--------------XXX---------
-------------XXXX---------
------------XXXXX---------
oo---------XXXXXX---------
----------XXXXXXX---------
---------XXXXXXXX---------
--------XXXXXXXXX--EE---EE
XXXXXXXXXXXXXXXXXXXXXXXXXX