-------------------------
-------------------------
-------------------------
-------------------------
-------------------------
-----------------XXXX----
----------------XXXXX----
---------------EXXXXX----
--------------XXXXXXX----
-------------XXXXXXXX----
--E--------EXXXXXXXXX----
-----------XXXXXXXXXX----
----------XXXXXXXXXXX----
XXXXXXXXXXXXXXXXXXXXXXXXX