---------------------------
---------------------------
---------------------------
---------------------------
---------------------------
----------------------SSSSS
---------------------------
---------------------------
-------------------SSS-----
-E-------------------------
<>---B---------------------
[]---b--B------------------
[]---B--b------E-----------
XXXXXXXXXXX-XXXXXXXXXXX----