--------------------------
--------------------------
--------------------------
--------------------------
--------------------------
--------XX------------XX--
-------XXX-----------XXX--
------EXXX----------XXXX--
-----XXXXX---------XXXXX--
----XXXXXX--------XXXXXX--
---XXXXXXX-------XXXXXXX--
--XXXXXXXX------XXXXXXXX--
-XXXXXXXXX-----XXXXXXXXX--
XXXXXXXXXXXXXXXXXXXXXXXXXX