--------------------------
--------------------------
--------------------------
--------------------------
--------------------------
------XXX-----------------
-----XXXX-------------E---
----XXXXX------------<>---
---XXXXXX------------[]---
---XXXXXX--S---------XX---
-XXXXXXXX-----------------
XXXXXXXXX---------------B-
---XXXXXX---------------b-
XXXXXXXXXXXXXXXX----XXXXXX