-----------------------------
-----------------------------
-----------------------------
-----------------------------
-----------------------------
--------------------S--------
-----------------------------
----------------X------------
----------------X--E-EE------
-------------XX-X------XX-X--
------------XXX-X------XX-X--
------E----XXXX-X------XX-X--
--X-------XXXXX-X------X--X--
XXXXX-X-XXXXXXX-X------X--X--