-------------------------
-------------------------
-------------------------
-------------------------
-------------------------
---------------------S---
-------------------------
-------------------------
-o-------?---------------
-------------------QQQQ--
-------------------------
-------------------------
-------------EE----------
---XXXXXXXXXXXXXXXXXXXXXX