---------------------------
---------------------------
---------------------------
---------------------------
---------------------------
----E--------------SSSSSS--
---<>----------------------
---[]----------------------
---[]----------------------
--SXXS---------------------
---------------------------
---------------------------
------------EE-------------
XXXXXXXXXXXXXXXXXXXXX-----X