------------------------------
------------------------------
------------------------------
------------------------------
------------------------------
XX----------------------------
XX----------------------------
XX-------E--------------------
XX------<>------XSS-SQ--------
XX------[]-----XXX------------
XX------[]----XXXX------------
--------[]---XXXXX------------
--------[]--XXXXXX--SSSSS-----
XXXXXXXXXXXXXXXXX-------XX-XXX