-----------------------------
-----------------------------
-----------------------------
-----------------------------
-----------------------------
-----------------------------
-----------------------------
-------------E---------------
------------<>----oo---------
---------X--[]---------------
--------XX--[]---------------
-------XXX--[]---------------
------XXXX--[]---------------
XXXXXXXXXXXXXXXXXXXXXXXXXXXXX