---------------------------
---------------------------
---------------------------
---------------------------
---------------------------
-----------------XXXX------
----------------XXXXX------
---------------XXXXXX------
------o-------XXXXXXX------
-------------XXXXXXXX------
------------XXXXXXXXX---E--
-----------XXXXXXXXXX------
----------XXXXXXXXXXX------
XXX-----XXXXXXXXXXXXXXXXXXX