-------------------------
-------------------------
-------------------------
-------------------------
-------------------------
-----------------------SS
-------------------------
-------------------------
-------------------------
-------------------------
-------------------------
-------------------------
-------------------------
XXXXXXXXXXXXXXXXXXXXXXXXX