--------------------------
--------------------------
--------------------------
--------------------------
--------------------------
------------------------XX
-----------------------XXX
-----XX---------------EXXX
----XXX--------------XXXXX
---XXXX----SSS------XXXXXX
--XXXXX------------XXXXXXX
-XXXXXX-----------XXXXXXXX
XXXXXXX----------XXXXXXXXX
XXXXXX--X--XXXXXXXXXXXXXXX