------------------------------
------------------------------
------------------------------
------------------------------
------------------------------
-------------SSSSSSSSSSSSS----
---------E--------------------
--------<>--------------------
----oo--[]--------------------
--------XXX-------------------
------------------------------
------------------------------
-----------------------------E
X------XXXXXXXXXXXX--------XXX