------------------------------
------------------------------
------------------------------
------------------------------
------------------------------
---------------------S--------
------------------------------
-----------------X------------
-----------------X--E-EE------
--------------XX-X------XX-X--
--------------XX-X------XX-X--
-----------X--XX-X------XX-X--
-E-EE-EE-E-X--XX-X------X--X--
XXXXXXXXXXXXXXXX-X------X--X--