--------------------------
--------------------------
--------------------------
--------------------------
--------------------------
------------------------SS
--------------------------
--------------------------
------S-------------------
--------------------------
----E---------------------
---<>---------------------
---[]---------------------
XXXXXXXXXXXXXXXXXXXXXXXXXX