-------------------------
-------------------------
-------------------------
-------------------------
-------------------------
-----------SSSS-------SS?
-------------------------
-------------------------
-------------------------
---------XX-----------SSS
--------XXX--------------
---B---XXXXX--------X----
---b--XXXXXX---EE-E-X----
XXXXXXXXXXXXXXXXXXXXXXXXX