---------------------------
---------------------------
---------------------------
---------------------------
---------------------------
------------------SS-------
---------------------------
---------------------------
---------------------------
-----------------XXXX------
-----X--------XXXXX-----E--
-----X-----XXXXXX----------
-----X----XXXXX------------
XXXXXXXXXXXXX------XX--X-XX