------------------------------
------------------------------
------------------------------
------------------------------
------------------------------
----------------------S-------
------------------------------
------------------X-----------
------------------X--E-EE-----
---------------XX-X------XX-X-
---------------XX-X------XX-X-
------------X--XX-X------XX-X-
EEE---X---E-X--XX-X------X--X-
XXXXXXXXXXXXXXXXX-X------X--X-