--------------------------
--------------------------
--------------------------
--------------------------
--------------------------
---------------------SSS--
--------------------------
--------------------------
--------------------------
--------------------XXXXX-
--------------------X-----
-E------------------X-----
----E-E-E-EE-E-EE---X-----
-X-XXXXXXXXXXXXXXXXXXXX---