--------------------------
--------------------------
--------------------------
--------------------------
--------------------------
----------------XXXX------
---------------XXXXX------
--------------XXXXXX------
-------------XXXXXXX------
------------XXXXXXXX------
-----------XXXXXXXXX---E--
----------XXXXXXXXXX------
--E---E--XXXXXXXXXXX------
XXXXXXXXXXXXXXXXXXXXXXXXXX