--------------------------
--------------------------
--------------------------
--------------------------
--------------------------
----------------XXXX------
---------------XXXXX------
--------------XXXXXX------
-S-----------XXXXXXX------
------------XXXXXXXX------
-----------XXXXXXXXX---E--
--------X-XXXXXXXXXX------
-------XXXXXXXXXXXXX------
XXXXXXXXXXXXXXXXXXXXXXXXXX