--------------------------
--------------------------
--------------------------
--------------------------
--------------------------
------XXXX----------------
-----XXXXX----------------
----XXXXXX----------------
---XXXXXXX----------------
---XXXXXXX---------ooo--Q-
-XXXXXXXXX----------------
XXXXXXXXXX----------------
---XXXXXXX----------------
XXXXXXXXXXXXXXXXXXXXXXXXXX