-----------------------------
-----------------------------
-----------------------------
-----------------------------
-----------------------------
--------------------SSSS-----
-----------------------------
-----------------------------
---------------------E-------
SS-----E-----------SSSSS-----
------<>---------------------
------[]---E-----------------
------[]-----------------EE--
XXXXXXXXXX-X-XXXX--XXXXXXXXXX