--------------------------
--------------------------
--------------------------
--------------------------
--------------------------
--------------------------
--------------------------
--------------------------
----------------------oo--
-------------------X------
-------------------X------
-------------------X------
-------------------X------
XXXXXXXXXXXX-X-----X-----X