--------------------------
--------------------------
--------------------------
--------------------------
--------------------------
------XXXX----------------
-----XXXXX----------------
----XXXXXX----------------
---XXXXXXX------------oo--
---XXXXXXX---------X------
-XXXXXXXXX---------X------
XXXXXXXXXX---------X------
---XXXXXXX---------X------
XXXXXXXXXXXXXX-----X-----X