-------------------------
-------------------------
-------------------------
-------------------------
-------------------------
-------------------------
-------------------------
-------------------------
-------------------------
-------------------------
-----E------X------------
------------X------------
------------X------------
--XXXXXXXX--XXXXXXXXXXXXX