-------------------------
-------------------------
-------------------------
-------------------------
-------------------------
-------------------------
-------------------------
----o--------------------
-----E-------------------
--SSSSS------------------
--E---------------------B
------E-----------------b
-------------E------E---B
XXXXXXXXXXXXXXXXXXXXXXXXX