--------------------------
--------------------------
--------------------------
--------------------------
--------------------------
------------S-------------
--------------------------
--------------------------
-o---------E-EE-----------
---------------XX-XX------
---------------XX-XX------
---------------XX-XX------
---------------X--XX-----X
---XXXXX-------X--XX--XXXX