--------------------------
--------------------------
--------------------------
--------------------------
--------------------------
------XX----------------SS
-----XXX------------------
----XXXX------------------
---XXXXX------------------
---XXXXX------------------
-XXXXXXX------------------
XXXXXXXX------------------
---XXXXX------------------
XXXXXXXXXXXXXXXXXXXXXXXXXX