---------------------------
---------------------------
---------------------------
---------------------------
---------------------------
-------------SSSSS---------
---------------------------
---------------------------
-------S-S-SS--------------
----X----------------------
---XX-----------------E----
--XXX----------------------
-XXXX----------------------
XXXXXXXXXXXXXX-----XXXXXXXX