------------------------------
------------------------------
------------------------------
------------------------------
------------------------------
------------SSSSSSSSSSSSS-----
------------------------------
------------------------------
------------------------------
---------X--------------------
--------XX--------------------
---B---XXX--------------------
---b--XXXX------------------EE
XXXXXXXXXXXXXXXXXX--------XXXX