------------------------------
------------------------------
------------------------------
------------------------------
------------------------------
--------------SSSSSSSSSSSSS---
------------------------------
------------------------------
-E----------------------------
<>----------------------------
[]----------------------------
[]-----<>---------------------
[]-----[]---------------------
XXXXXXXXXXX-XXXXXXXX--------XX