--------------------------
--------------------------
--------------------------
--------------------------
--------------------------
--------SS---SSS----------
--------------------------
--------------------------
-------------------------o
--------SS--XXXXX---------
------------X-------------
------------X-------------
------------X-------------
--XXXXXXXXXXXXX----X------