--------------------------
--------------------------
--------------------------
--------------------------
--------------------------
--------------------------
--------------------------
--------------------------
--------------------------
--------------------------
---E----------------------
--------X-X--------------<
--------X-X--------------[
XXXXXXXXXXXXXXXXXXXXXXXXXX