----------------------------
----------------------------
----------------------------
----------------------------
----------------------------
-----------------------SSSSS
----------------------------
----------------------------
--------------------SSS-----
----------------------------
----------------------------
----------------------------
-E-E-E-E-E------E-----------
XXXXXXXXXXXX-XXXXXXXXXXX----