---------------------------
---------------------------
---------------------------
---------------------------
---------------------------
------XXXX----------XX-----
-----XXXXX----------XX-----
----XXXXXX----------XX-----
---XXXXXXX-------XX-XX-----
---XXXXXXX------XXX-XX-----
-XXXXXXXXX-----XXXX-XX-----
XXXXXXXXXX----XXXXX-XX-----
---XXXXXXX--XXXXXXX-XX-----
XXXXXXXXXXXXXXXXXX--XXXXXXX