---------------------------
---------------------------
---------------------------
---------------------------
---------------------------
-------------------SSSSSS--
---------------------------
---------------------------
---------------------------
---------------------------
---------------------------
---------------------------
-E-EE-EE-E-EEE-------------
XXXXXXXXXXXXXXXXXXXXX-----X