-------------------------
-------------------------
-------------------------
-------------------------
-------------------------
-------------------------
-------------------------
-------------------------
-------------------------
-------------------Q-----
-------------------------
-X-----------------------
-X--------EE-EE----------
XXXXXXXXXXXXXXXXXXXXXXXXX