------------------------------
------------------------------
------------------------------
------------------------------
------------------------------
--------XX--------------------
-------XXX--------------------
------EXXX--------------------
-----XXXXX--------------------
----XXXXXX--------------------
---XXXXXXX--------------------
--XXXXXXXX--XX-X--------------
-XXXXXXXXX--XX-X--------------
XXXXXXXXXXXXXXXXXXXXXXXXXXXXXX