------------------------------
------------------------------
------------------------------
------------------------------
------------------------------
------------XX----------------
------------XX----------------
---------XX-XX----------------
---------XX-XX------------oo--
-Q-------XX-XX---------X------
--------XXX-XX---------X------
--------XXX-XX---------X------
-E------XXX-XX---------X------
XXXXXXXXXXX-XXXXXX-----X-----X