----------------------------
----------------------------
----------------------------
----------------------------
----------------------------
----------------------------
----------------------------
----------------------------
------S---------oo-----E----
---------E------------<>----
----E---<>------------[]----
---<>---[]------------[]----
---[]---[]------------[]-E-E
XXXXXXXXXXXX--X----X--XXXXXX