-----------------------------
-----------------------------
-----------------------------
-----------------------------
-----------------------------
-------------------XXXX------
------------------XXXXX------
-----------------XXXXXX------
----------------XXXXXXX------
------X--------XXXXXXXX------
-----XXX------XXXXXXXXX---E--
----XXXX-----XXXXXXXXXX------
---XXXX-----XXXXXXXXXXX------
XXXXXXX---XXXXXXXXXXXXXXXXXXX