------------------------------
------------------------------
------------------------------
------------------------------
------------------------------
------------------------------
------------------------------
--------------XSS--o----------
------o------XXX--------------
-------------XXX-SS-----------
-----------XXXXX-------X------
----------XXXXXX--SSS--X------
-------------XXX-------X------
XXX-----XXXXXXX------XXXXXXXXX