----------------------------
----------------------------
----------------------------
----------------------------
----------------------------
--------------------SSSSSS--
----------------------------
----------------------------
-o-------?------------------
----------------------------
----------------------------
----------------------------
------------EEE-------------
---XXXXXXXXXXXXXXXXXXX-----X