---------------------------
---------------------------
---------------------------
---------------------------
---------------------------
------------------S--------
---------------------------
--------------X------------
---------E----X--E-EE------
-------E<>--X-X------XX-X--
------<>[]--X-X------XX-X--
------[][]--X-X------XX-X--
------[][]--X-X------X--X--
X--XXXXXXX--X-X------X--X--