------------------------------
------------------------------
------------------------------
------------------------------
------------------------------
----------------------S-------
------------------------------
------------------X-----------
------------------X--E-EE-----
---------------XX-X------XX-X-
--------------XXX-X------XX-X-
-------------XXXX-X------XX-X-
-E-EE-EE-E--XXXXX-X------X--X-
XXXXXXXXXXXXXXXXX-X------X--X-