---------------------------
---------------------------
---------------------------
---------------------------
---------------------------
---------------------------
---------------------------
---------------------------
---------------oo-----E----
---------------------<>----
---------------------[]----
---------------------[]----
---X--EE-------------[]-E-E
XXXXXXXXXX---X----X--XXXXXX