------------------------------
------------------------------
------------------------------
------------------------------
------------------------------
--------------XXXX------------
-------------XXXXX------------
------------XXXXXX------------
---oo------XXXXXXX------------
-----------XXXXXXX---------X--
---------XXXXXXXXX---------X--
--------XXXXXXXXXX---------X--
-----------XXXXXXX---------X--
------XXXXXXXXXXXXXXXX-----X--