----------------------------
----------------------------
----------------------------
----------------------------
----------------------------
----------------------------
----------------------------
----------------------------
---Q-----------X------------
Q-E-----------XX------------
--E----------XXX------------
------------XXXX------------
-----------XXXXX---XX----X--
XXXXXXXXXXXXXXXXXXXXXXXXXXXX