---------------------------
---------------------------
---------------------------
---------------------------
---------------------------
------------------S--------
---------------------------
--------------X------------
--------------X--E-EE------
-----------XX-X------XX-X--
--<>------XXX-X------XX-X--
--[]-----XXXX-X------XX-X--
--[]-E--XXXXX-X------X--X--
XXXXXXXXXXXXX-X------X--X--