--------------------------
--------------------------
--------------------------
--------------------------
--------------------------
-SSSSSS----------SSS------
--------------------------
--------------------------
--------------------------
----------------XXXXX-----
----------------X---------
----------------X---------
----------------X---------
XXXXX---XXXXXXXXXXX-----XX