---------------------------
---------------------------
---------------------------
---------------------------
---------------------------
----------------------SSS--
---------------------------
---------------------------
---------------------------
Q--------------------XXXXX-
---------------------X-----
---------------------X-----
------EE-E-EE-E-EE---X-----
XXXXXXXXXXXXXXXXXXXXXXXX---