-----------------------------
-----------------------------
-----------------------------
-----------------------------
-----------------------------
--------------------S--------
-----------------------------
-------X--------X------------
------XX---E----X--E-EE------
-----XXX--<>--X-X------XX-X--
----XXXX--[]--X-X------XX-X--
---XXXXX--[]--X-X------XX-X--
--XXXXXX--[]--X-X------X--X--
XXXXXXXXXXXX--X-X------X--X--