--------------------------
--------------------------
--------------------------
--------------------------
--------------------------
-------SSSSS----------XX--
---------------------XXX--
--------------------XXXX--
-------------------XXXXX--
------X-----------XXXXXX--
------X----------XXXXXXX--
------X---------XXXXXXXX--
-E----X--------XXXXXXXXX--
XXXXXXXXX----XXXXXXXXXXXXX