---------------------------
---------------------------
---------------------------
---------------------------
---------------------------
-----------------XXXX------
----------------XXXXX------
---------------XXXXXX------
--------------XXXXXXX------
oo-----------XXXXXXXX------
----------X-XXXXXXXXX---E--
---------XXXXXXXXXXXX------
--------XXXXXXXXXXXXX------
XXXXXXXXXXXXXXXXXXXXXXXXXXX