-----------------------------
-----------------------------
-----------------------------
-----------------------------
-----------------------------
-?SS---------------XXXX------
------------------XXXXX------
-----------------XXXXXX------
----------------XXXXXXX------
---------------XXXXXXXX------
--B-----------XXXXXXXXX---E--
--b-----X----XXXXXXXXXX------
--B----XXX--XXXXXXXXXXX------
XXXXXXXXXXXXXXXXXXXXXXXXXXXXX