-----------------------------
-----------------------------
-----------------------------
-----------------------------
-----------------------------
-------------SSSSSSS---------
-----------------------------
-----------------------------
-----------------------------
-----------------------------
-----------E-----------------
----------<>-----------------
EEE---X---[]------------E----
XXXXXXXXXXXXXXX------XXXXXXXX