------------------------------
------------------------------
------------------------------
------------------------------
------------------------------
--------------------XXXX------
-------------------XXXXX------
------------------XXXXXX------
-----------------XXXXXXX------
Q---------------XXXXXXXX------
---------------XXXXXXXXX---E--
-----------<>-XXXXXXXXXX------
------EE---[]XXXXXXXXXXX------
XXXXXXXXXXXXXXXXXXXXXXXXXXXXXX