-------------------------
-------------------------
-------------------------
-------------------------
-------------------------
-------------------------
-------------------------
--------XSS--o-----------
-------XXX---------------
------XXXX-SS------------
-----XXXXX-------X-------
----XXXXXX--SSS--X-------
---XXXXXXX-------X-------
XXXXXXXXX------XXXXXXXXXX