------------------------------
------------------------------
------------------------------
------------------------------
------------------------------
------XX----------------------
-----XXX----------------------
----XXXX----------------------
---XXXXX--S---------oo-----E--
---XXXXX-----E------------<>--
-XXXXXXX----<>------------[]--
XXXXXXXX----[]------------[]--
---XXXXX----[]------------[]-E
XXXXXXXXXXXXXXXX--X----X--XXXX