------------------------------
------------------------------
------------------------------
------------------------------
------------------------------
------------------------------
------------------------------
------------------------------
-----------------XSS-SQ-------
----------------XXX-----------
---------------XXXX-----------
--------------XXXXX-----------
-------------XXXXXX--SSSSS----
XXX---X---XXXXXXXX-------XX-XX