--------------------------
--------------------------
--------------------------
--------------------------
--------------------------
--------------------XXXXX-
-------------------XXXXXX-
------------------EXXXXXX-
---Q-----------X-XXXXXXXX-
Q-E-----------XXXXXXXXXXX-
--E----------XXXXXXXXXXXX-
------------XXXXXXXXXXXXX-
-----------XXXXXXXXXXXXXX-
XXXXXXXXXXXXXXXXXXXXXXXXXX