-------------------------
-------------------------
-------------------------
-------------------------
-------------------------
-------------------------
---------------------E---
----o---------------<>---
-----E--------------[]---
--SSSSS-------------XX---
--E----------------------
------E----------------B-
-----------------------b-
XXXXXXXXXXXXXXX----XXXXXX