----------------------------
----------------------------
----------------------------
----------------------------
----------------------------
--------------------SSSSSS--
----------------------------
----------------------------
----------------------------
----------------------------
----------------------------
----------------------------
--X--E-EE-E-EEE-------------
XXXXXXXXXXXXXXXXXXXXXX-----X