--------------------------
--------------------------
--------------------------
--------------------------
--------------------------
----------------XX--------
---------------XXX--------
--------------XXXX-------o
-------------XXXXX--------
-------------XXXXX-----SS-
-----------XXXXXXX--------
----------XXXXXXXX--------
------EE-----XXXXX--------
XXXXXXXXXXXXXXXXXXXXXXXXXX