---------------------------
---------------------------
---------------------------
---------------------------
---------------------------
------XX---------XX--------
-----XXX--------XXX--------
----XXXX-------XXXX-------o
---XXXXX------XXXXX--------
---XXXXX------XXXXX-----SS-
-XXXXXXX----XXXXXXX--------
XXXXXXXX---XXXXXXXX--------
---XXXXX------XXXXX--------
XXXXXXXXXXXXXXXXXXXXXXXXXXX