-----------------------------
-----------------------------
-----------------------------
-----------------------------
-----------------------------
-SSS-----------------SSSSSS--
-----------------------------
-----------------------------
-----------------------------
XXXXX------------------------
X----------------------------
X----------------------------
X-------EE-E-EEE-------------
XXX----XXXXXXXXXXXXXXXX-----X