--------------------------
--------------------------
--------------------------
--------------------------
--------------------------
--------------------------
--------------------------
--------------------------
--------------o----oo-----
----------E---------------
---------<>---------------
---------[]---------------
------E--[]---------------
X---XXXXXXXXX---X-----X---