---------------------------
---------------------------
---------------------------
---------------------------
---------------------------
--------SSSSSSSSSSSSSS-----
---------------------------
---------------------------
---------------------------
---------------------------
---------------------------
---------------------------
-EE-EE-------------------EE
XXXXXXXXXXXXXXX--------XXXX