-------------------------
-------------------------
-------------------------
-------------------------
-------------------------
--------------E----------
-------------<>----------
-------------[]----------
-------------[]----------
--------E---SXXS---------
-------<>----------------
-------[]----------------
-------[]----------------
XXXXXXXXXXXXXXXXXXXXXXXXX