---------------------------
---------------------------
---------------------------
---------------------------
---------------------------
---------------------------
---------------------------
---------------------------
-----------------------oo--
SS------------------X------
--------------------X------
--------------------X------
-------E------------X------
XXXXXXXXXXXXX-X-----X-----X