-----------------------------
-----------------------------
-----------------------------
-----------------------------
-----------------------------
------------------------SSSSS
-----------------------------
-----------------------------
---------------------SSS-----
-----------------------------
-----------------------------
-----------------------------
-----EE-E-E------E-----------
XXXXXXXXXXXXX-XXXXXXXXXXX----