---------------------------
---------------------------
---------------------------
---------------------------
---------------------------
-------------SSSSS---------
---------------------------
---------------------------
-----------SS--------------
-----E---------------------
---E<>----------------E----
--<>[]---------------------
--[][]--X------------------
XXXXXXXXXXXXXX-----XXXXXXXX