---------------------------
---------------------------
---------------------------
---------------------------
---------------------------
---------------------XXXXX-
--------------------XXXXXX-
-------------------EXXXXXX-
----------------X-XXXXXXXX-
Q--------------XXXXXXXXXXX-
--------------XXXXXXXXXXXX-
-------------XXXXXXXXXXXXX-
---X--------XXXXXXXXXXXXXX-
XXXXXXXXXXXXXXXXXXXXXXXXXXX