----------------------------
----------------------------
----------------------------
----------------------------
----------------------------
--------XX---------S--------
-------XXX------------------
------EXXX-----X------------
-----XXXXX-----X--E-EE------
----XXXXXX--XX-X------XX-X--
---XXXXXXX--XX-X------XX-X--
--XXXXXXXX--XX-X------XX-X--
-XXXXXXXXX--XX-X------X--X--
XXXXXXXXXXXXXX-X------X--X--