-----------------------------
-----------------------------
-----------------------------
-----------------------------
-----------------------------
------XXX---------XX---------
-----XXXX--------XXX---------
----XXXXX-------XXXX---------
---XXXXXX------XXXXX---------
---XXXXXX-----XXXXXX---------
-XXXXXXXX----XXXXXXX---------
XXXXXXXXX---XXXXXXXX---------
---XXXXXX--XXXXXXXXX--EE---EE
XXXXXXXXXXXXXXXXXXXXXXXXXXXXX