------------------------------
------------------------------
------------------------------
------------------------------
------------------------------
-?SS----------XX--------------
-------------XXX--------------
------------XXXX--------------
-----------XXXXX--------------
----------XXXXXX---------ooo--
--B------XXXXXXX--------------
--b-----XXXXXXXX--------------
--B----XXXXXXXXX--------------
XXXXXXXXXXXXXXXXXXXXXXXXXXXXXX