----------------------------
----------------------------
----------------------------
----------------------------
----------------------------
-SSSSSS---SS---SSS----------
----------------------------
----------------------------
---------------------------o
----------SS--XXXXX---------
--------------X-------------
--------------X-------------
--------------X-------------
XXXXX---XXXXXXXXX----X------