--------------------------
--------------------------
--------------------------
--------------------------
--------------------------
----------SSSSSSSSSSS-----
--------------------------
--------------------------
--------------------------
--------------------------
--------------------------
--------------------------
---X--EE----------------EE
XXXXXXXXXXXXXX--------XXXX