----------------------------
----------------------------
----------------------------
----------------------------
----------------------------
----------------------------
----------------------------
--B-------------------------
--b-------------o----oo-----
SSXSSS------E---------------
-----------<>---------------
-----------[]---------------
--------E--[]---------------
XXXXXXXXXXXXXXX---X-----X---