-------------------------
-------------------------
-------------------------
-------------------------
-------------------------
-------------------------
-------------------------
-------------------------
--E----------------------
-<>---E------------------
-[]--<>------------------
-[]--[]--X--------------<
-[]--[]--X--------------[
XXX--XXXXXXXXXXXXXXXXXXXX