--------------------------
--------------------------
--------------------------
--------------------------
--------------------------
----SSSSSS----------------
--------------------------
--------------------------
-----E--------o----oo-----
---SSSSSSS----------------
--------------------------
--------------------------
--------------------------
X--XXXXXXXXXX---X-----X---