--------------------------
--------------------------
--------------------------
--------------------------
--------------------------
-----------SSSSSS---------
--------------------------
--------------------------
--------SSS---------------
--X-----------------------
--XX----------------------
--XXX---------------------
--XXXX---------------E----
XXXXXXXXXXXX------XXXXXXXX