---------------------------
---------------------------
---------------------------
---------------------------
---------------------------
--------SSSSSSSSSSSSSS-----
---------------------------
---------------------------
---------------------------
---------------------------
---------------------------
---------------------------
---E---------------------EE
X-XXXXXXXXXXXXX--------XXXX