---------------------------
---------------------------
---------------------------
---------------------------
---------------------------
---------------------------
---------------------------
---------------------------
---------------o----oo-----
-----------E---------------
--------<-<>---------------
--------[-[]---------------
EE---E--[-[]---------------
XXXXXXXXXXXXXX---X-----X---