------------------------------
------------------------------
------------------------------
------------------------------
------------------------------
----XX---------SSSSSSSSSSSSS--
----XX-----E------------------
-XX-XX----<>------------------
-XX-XX----[]------------------
-XX-XX----XXX-----------------
XXX-XX------------------------
XXX-XX------------------------
XXX-XX------------------------
XXX-XXXXXXXXXXXXXXXXX--------X