---------------------------
---------------------------
---------------------------
---------------------------
---------------------------
---------------------------
---------------------------
--------X------------------
-------XX------------------
------XXX------------------
-----XXXX-----------------<
----XXXXX----X------------[
---XXXXXX--E-X-----X------[
XXXXXXXXXXXXXXXXXXXXXXXXXXX