---------------------------
---------------------------
---------------------------
---------------------------
---------------------------
---------------------------
---------------------------
---------------------------
---------------oo-----E----
---------------------<>----
---------------------[]----
---------------------[]----
------EE-------------[]-E-E
XXXXXXXXXX---X----X--XXXXXX