----------------------------
----------------------------
----------------------------
----------------------------
----------------------------
---S------------------------
----------------------------
----------------------------
--E-EE---------E------------
------XX-X----<>--X---------
------XX-X----[]--XX--------
------XX-X----[]--XXX---B---
------X--X----[]--XXXX--b---
------X--X--XXXXXXXXXXXXXXXX