----------------------------
----------------------------
----------------------------
----------------------------
----------------------------
----------------------------
----------------------------
----------------------------
---Q------------oo-----E----
Q-E-------------------<>----
--E-------------------[]----
----------------------[]----
------EEE-------------[]-E-E
XXXXXXXXXXX---X----X--XXXXXX