------------------------------
------------------------------
------------------------------
------------------------------
------------------------------
--------------SSSSSSS---------
------------------------------
------------------------------
-----E------------------------
----<>------------------------
----[]------E-----------------
----[]-----<>-----------------
----[]-----[]------------E----
XXXXXX--XXXXXXXX------XXXXXXXX