-------------------------
-------------------------
-------------------------
-------------------------
-------------------------
-------------------------
-------------------------
-------------------------
--------------------Q----
----------SSSSS--Q-E-----
----E--------------E-----
-------------------------
-------------------------
XXXXXXXXX-XXXXXXXXXXXXXXX