----------------------------
----------------------------
----------------------------
----------------------------
----------------------------
XX------SSSSSSSSSSSSSSS-----
XX--------------------------
XX--------------------------
XX--------------------------
XX--------------------------
XX--------------------------
----------------------------
--------------------------EE
XXXXXXXXXXXXXXXX--------XXXX