------------------------------
------------------------------
------------------------------
------------------------------
------------------------------
--------------S---------------
---oo-------------------------
------------------------------
-E-----SS----E-EE-------------
<>---------------XX-X---------
[]---------------XX-X---------
[]---------------XX-X---------
[]---------------X--X---------
XXXXXXXXXXX------X--X--XXXXXXX