---------------------------
---------------------------
---------------------------
---------------------------
---------------------------
-----------SSSSSSSSSSS-----
---------------------------
---------------------------
----E----------------------
---<>----------------------
---[]----------------------
---[]--<>------------------
--E[]--[]----------------EE
XXXXXXXXXXXXXXX--------XXXX