------------------------------
------------------------------
------------------------------
------------------------------
------------------------------
-----------------------S------
------------------------------
-----XX------------X----------
----XXX------------X--E-EE----
---XXXX---------XX-X------XX-X
--XXXXX---------XX-X------XX-X
-XXXXXX------X--XX-X------XX-X
XXXXXXX--E-E-X--XX-X------X--X
XXXXXX--XXXXXXXXXX-X------X--X