------------------------------
------------------------------
------------------------------
------------------------------
------------------------------
-------------------S----------
--------oo--------------------
------------------------------
---o--------SS----E-EE--------
----------------------XX-X----
------X---------------XX-X----
------X---------------XX-X----
------X---------------X--X----
------XXXXXXXXXX------X--X--XX