----------------------------
----------------------------
----------------------------
----------------------------
----------------------------
------------SSSSSSSSSSS-----
----------------------------
----------------------------
--E-------------------------
-<>---E---------------------
-[]--<>---------------------
-[]--[]--X------------------
-[]--[]--X----------------EE
XXX--XXXXXXXXXXX--------XXXX