--------------------------
--------------------------
--------------------------
--------------------------
--------------------------
--------------------------
--------------------------
--------------------------
--------------------------
--------------------------
-----------X--------------
-----------X--------------
-E-EE-EE---X--E-E-E-E-----
XXXXXXXXX--XXXXXXXXXXXXXXX