------------------------------
------------------------------
------------------------------
------------------------------
------------------------------
--------------SSSSSSSSSSSSS---
------------------------------
------------------------------
------------------------------
------------------------------
------------------------------
---X--------------------------
---X------E-------------------
XXXXXXXXXXXXXXXXXXXX--------XX