------------------------------
------------------------------
------------------------------
------------------------------
------------------------------
---------------SSSSSSSSSSSSS--
------------------------------
------------------------------
------------------------------
------------------------------
---E--------------------------
-------<<>--------------------
-------[[]--------------------
XXXXXXXXXXXX-XXXXXXXX--------X