-------------------------
-------------------------
-------------------------
-------------------------
-------------------------
-------------------------
-------------------------
---------------------X---
--------------------XX---
-------------------XXX---
------------------XXXX---
-B---------------XXXXX---
-b--EE----------XXXXXX---
XXXXXXXXXXX--XXXXXXXXXXXX