------------------------------
------------------------------
------------------------------
------------------------------
------------------------------
--------------------S---------
------------------------------
------------------------------
-----------S-SS----E-EE-------
-----------------------XX-X---
---------E-------------XX-X---
--------<>-------------XX-X---
--------[]-------------X--X---
XXXXXXXXXXXXXXXXX------X--X--X