----------------------------
----------------------------
----------------------------
----------------------------
----------------------------
---------XX--SSSSSSSSSS-----
--------XXX-----------------
-------XXXX-----------------
------XXXXX-----------------
-----XXXXXX-----------------
----XXXXXXX-----------------
---XXXXXXXX-----------------
XXXXXXXXXXX---------------EE
XXXXXXXXXXXXXXXX--------XXXX