------------------------------
------------------------------
------------------------------
------------------------------
------------------------------
-------S----------------------
------------------------------
----------------------------X-
------E-EE------------------X-
----------XX-X------------X-X-
----------XX-X------------X-X-
----------XX-X------------X-X-
----------X--X------------X-X-
XXXX------X--X--X--XXXXX--X-X-