----------------------------
----------------------------
----------------------------
----------------------------
----------------------------
------XX------------SSSSSS--
-----XXX--------------------
----XXXX--------------------
---XXXXX--------------------
---XXXXX--------------------
-XXXXXXX--------------------
XXXXXXXX--------------------
---XXXXX-----EE-------------
XXXXXXXXXXXXXXXXXXXXXX-----X