------------------------------
------------------------------
------------------------------
------------------------------
------------------------------
---------------------S--------
------------------------------
-----------------X------------
------------E----X--E-EE------
---Q-----E<<>--X-X------XX-X--
--------<>[[]--X-X------XX-X--
--------[][[]--X-X------XX-X--
--------[][[]--X-X------X--X--
XXXXXXXXXXXXX--X-X------X--X--