---------------------------
---------------------------
---------------------------
---------------------------
---------------------------
----SSSSSSS----------------
---------------------------
---------------------------
------E--------o----oo-----
----SSSSSSS----------------
---------------------------
---------------------------
EE-------------------------
XXXXXXXXXXXXXX---X-----X---