------------------------------
------------------------------
------------------------------
------------------------------
------------------------------
-----E-----------------SSSSSS-
------------------------------
-------X----------------------
-----EXX----------------------
----<>XX----------------------
----[]XX----------------------
---X[]XX----------------------
--XX[]XX--EE-E-EEE------------
XXXXXXXXXXXXXXXXXXXXXXXXX-----