--------------------------
--------------------------
--------------------------
----------------o---------
--------------------------
------XXXX--S-SSS-----SSSS
-----XXXXX----------------
----XXXXXX----------------
---XXXXXXX----------SS----
---XXXXXXX-----S----------
-XXXXXXXXX----------------
XXXXXXXXXX----------------
---XXXXXXX------E---------
XXXXXXXXXXXXXXXXXXXXXXX---