------------------------------
------------------------------
------------------------------
------------------------------
------------------------------
-----------XXX---------XX-----
----------XXXX--------XXX-----
---------XXXXX-------XXXX-----
--------XXXXXX------XXXXX-----
--------XXXXXX-----XXXXXX-----
--E---XXXXXXXX----XXXXXXX-----
-----XXXXXXXXX---XXXXXXXX-----
--------XXXXXX--XXXXXXXXX--EE-
XXXXXXXXXXXXXXXXXXXXXXXXXXXXXX