-------------------------
-------------------------
-------------------------
-------------------------
-------------------------
---------------SSSSS-----
-------------------------
-------------------------
-------------------------
--SS---------------------
-------------------------
-----B-------------------
-----b-------------------
XXXXXXXXX--X-XXXXX---XXXX