------------------------------
------------------------------
------------------------------
------------------------------
------------------------------
---S---------------SSSSS------
------------------------------
------------------------------
--E-EE-----------SS-----------
------XX-X--------------------
------XX-X------------------E-
------XX-X--------------------
------X--X----X---------------
------X--X--XXXXXXXX-----XXXXX