--------------------------
--------------------------
--------------------------
--------------------------
--------------------------
----SSSS----------XXXX----
-----------------XXXXX----
----------------EXXXXX----
-----E---------XXXXXXX----
---SSSSS------XXXXXXXX----
------------EXXXXXXXXX----
------------XXXXXXXXXX----
-----------XXXXXXXXXXX----
X--XXXXXXXXXXXXXXXXXXXXXXX