-----------------------------
-----------------------------
-----------------------------
-----------------------------
-----------------------------
---S-----------------SSSSSS--
-----------------------------
-----------------------------
--E-EE-----------------------
------XX-X-------------------
------XX-X-------------------
------XX-X-------------------
------X--X---EEE-------------
------X--X--XXXXXXXXXXX-----X