----------------------------
----------------------------
----------------------------
----------------------------
----------------------------
-------------SSSSSSSSSS-----
----------------------------
----------------------------
----------------------------
----------------------------
----------------------------
----------------------------
EEE---X---E---------------EE
XXXXXXXXXXXXXXXX--------XXXX