------------------------------
------------------------------
------------------------------
------------------------------
------------------------------
--------------SSSSSSSSSSSSS---
----------E-------------------
---------<>-------------------
---------[]-------------------
---------XXX------------------
------------------------------
------------------------------
-EE-EE------------------------
XXXXXXXXXXXXXXXXXXXX--------XX