---------------------------
---------------------------
---------------------------
---------------------------
---------------------------
-------------S-------------
---------------------------
---------------------------
------------E-EE-----------
----------------XX-XX------
--B-------------XX-XX------
--b-------------XX-XX------
--B-------------X--XX-----X
XXXXXXXXXX------X--XX--XXXX