---------------------------
---------------------------
---------------------------
---------------------------
---------------------------
------------SSSSSS---------
---------------------------
---------------------------
---------SSS---------------
---------------------------
---------------------------
---------------------------
-----XX---------------E----
--XXXXXXXXXXX------XXXXXXXX