-------------------------
-------------------------
-------------------------
-------------------------
-------------------------
-------------------------
-------------------------
-------------------------
-------------------oo----
------------------o------
-------------------------
----------B--------------
----------b--------------
XXXXXXXXXXXXXXXXXXXXXXXXX