-------------------------
-------------------------
-------------------------
-------------------------
-------------------------
-------------------------
----------------E--------
---------------<>--------
------------o--[]-----E--
---------------XX----<>--
---------------------[]--
------------------B--[]--
-EE--XX-----------b--[]--
XXXXXXXXXXX---XXXXXXXXXXX