-------------------------
-------------------------
-----------------?-------
-------------------------
-------------------------
-------------------------
-------------------SS----
-------------------------
-------------SSSS--------
---Q-----E------------XXX
--------<>-----------XXXX
--------[]----------XXXXX
--------[]---------XXXXXX
XXXXXXXXXXXXXXXXXX-XXXXX-