-------------------------
-------------------------
-------------------------
-------------------------
-------------------------
------------------------E
-------------------------
-------------------------
-------o----------------E
-----------------------<>
-----------------------[]
----------------------X[]
---------------------XX[]
XXXXX-----XXXXXXXXXXXXXXX