-------------------------
-------------------------
-------------------------
-------------------------
-------------------------
------XXX----------------
-----XXXX----------------
----XXXXX----------------
---XXXXXX----------------
---XXXXXX--SS------------
-XXXXXXXX----------X-----
XXXXXXXXX----------X-----
---XXXXXX----------X-----
XXXXXXXXXXXXXXX-X--XXXXXX