-------------------------
-------------------------
-------------------------
-------------------------
-------------------------
----E---XXXXX--SSSS------
-------XXXXXX------------
------XXXXXXX------------
----EXXXXXXXX---E--------
---<>XXXXXXXX--SSSS------
---[]XXXXXXXX------------
--X[]XXXXXXXX------------
-XX[]XXXXXXXX------------
XXXXXXXXXXXXXXXXXXXXXXXXX