-------------------------
-------------------------
-------------------------
-------------------------
-------------------------
-------SSSSS------------S
-------------------------
-------------------------
-------------------------
------X-----------------S
------X------------------
------X------------------
-E----X------------------
XXXXXXXXX----XXXXXXXXXXXX