-------------------------
-------------------------
-------------------------
-------------------------
-------------------------
------------------SS-----
-------------------------
-------------------------
-------------------------
-----------------XXXX----
---------E----XXXXX------
-----------XXXXXX--------
----------XXXXX----------
XXX-XXXXXXXXX------XX--XX