-------------------------
-------------------------
-------------------------
-------------------------
-------------------------
----------------SSSS-----
-------------------------
-------------------------
-----------------E-------
---------------SSSSS-----
-------------------------
-------E-----------------
---------------------EE--
XXXXXX-X-XXXX--XXXXXXXXXX