-------------------------
-------------------------
-------------------------
-------------------------
-------------------------
-------------------------
-------------------------
-------------------------
-----------------o-------
-------------------------
-------------------------
-------------------------
----EE-----X-------------
XXXXXXXXXXXXXXX-----XXXXX