-------------------------
-------------------------
-------------------------
-------------------------
-------------------------
-------------------------
-------------------------
-------------------------
--------------------o----
------E------------------
-----<>---E--------------
-----[]--<>-----E--------
-----[]--[]--------------
XXXXXXXXXXXXXXX-X-X---X--