-------------------------
-------------------------
-------------------------
-------------------------
-------------------------
-------------------------
-------------------------
-------------------------
----------oo-------------
-Q----------o-------<>---
--------------------[]---
--------------------[]---
-E------------------[]---
XXXXXXXXXXXXXXXXXXXXXXXXX