-------------------------
-------------------------
-------------------------
-------------------------
-------------------------
---------------------XXX-
--------------------XXXX-
-------------------XXXXX-
-------E----------XXXXXX-
------<>---------XXXXXXX-
--E---[]--------XXXXXXXX-
-<>---[]-------XXXXXXXXX-
-[]---[]------XXXXXXXXXX-
XXXXXXXXXXXXXXXXXXXXXXXXX