-------------------------
-------------------------
-------------------------
-------------------------
-------------------------
-------------------------
-------------E-----------
------------<>----------E
------------[]-----------
----E-------XXX-------S?S
---<>--------------------
---[]--------------------
---[]-------------E------
XXXXX---XXXXXXXXXXXXXXXXX