-------------------------
-------------------------
-------------------------
-------------------------
-------------------------
-SSS------------XXXX---SS
----------------XXXX-----
----------------XXXX-----
-------------XX-XXXX-----
XXXXX-------XXX-XXXX----S
X----------XXXX-XXXX-----
X---------XXXXX-XXXX-----
X--------XXXXXX-XXXX-----
XXX----XXXXXXX--XXXXXXXXX