-------------------------
-------------------------
-------------------------
-------------------------
-------------------------
-------------------------
--------------------ooooo
-------------------------
------------------E------
-------E---------<>------
------<>----B----[]------
------[]----b----[]------
------[]---------[]------
--X---XXXXXXXXXXXXXXXXXXX