-------------------------
-------------------------
-------------------------
-------------------------
-------------------------
-------------------------
-------------------------
-------------------------
----E--------------------
---<>--------------------
---[]--------------------
---[]--<>--<>---------XXX
--E[]--[]--[]--------XXXX
XXXXXXXXXXXXXXXXXXXXXXXX-