-------------------------
-------------------------
-------------------------
-------------------------
-------------------------
-------------------------
-------------------------
-------------------------
-------------------------
----------------------Q--
-------------------------
-------------------------
-------E--------E--------
XXXXXXXXX--XXXXXXXXXXXXXX