-------------------------
-------------------------
-------------------------
-------------------------
-------------------------
-------------------------
-------------------------
-------------------------
-------------------------
--XSSS----SSS---QQQ------
--X----------------------
--X-------------E--------
-EX----------------------
XXXXXXXXXXXXXXXXXXXXXXXXX