-------------------------
-------------------------
-------------------------
-------------------------
-------------------------
-----E-------------------
-------------------------
-------X-----------------
-----EXX-----E-----------
----<>XX----<>-----------
----[]XX----[]------E----
---X[]XX----[]-----------
--XX[]XX----[]-----------
XXXXXXXXXXXXXXXXXXXXXXXXX