-------------------------
-------------------------
-------------------------
-------------------------
-------------------------
-------XX----------------
-------XX------------E---
-------XX-----------<>---
----XX-XX-----------[]---
---XXX-XX-----------XX---
-EXXXX-XX----------------
-XXXXX-XX--------------B-
XXXXXX-XX--------------b-
XXXXX--XXXXXXXX----XXXXXX