-------------------------
-------------------------
-------------------------
-------------------------
-------------------------
----------------SS-------
-------------------------
-------------------------
-------------------------
---------------XXXX------
------------XXXXX-----E--
---------XXXXXX----------
--------XXXXX------------
XXXXXXXXXXX------XX--X-XX