-------------------------
-------------------------
-------------------------
-------------------------
-------------------------
-------------------XXXXX-
------------------XXXXXX-
-----------------EXXXXXX-
----------------XXXXXXXX-
---------------XXXXXXXXX-
-----------E--XXXXXXXXXX-
-------------XXXXXXXXXXX-
--E---------XXXXXXXXXXXX-
XXXXXXXXXXXXXXXXXXXXXXXXX