-------------------------
-------------------------
-------------------------
-------------------------
-------------------------
-SSSSS-------------------
-------------------------
-------------------------
-------------------------
------------------ooo--Q-
-------------------------
-------------------------
-------------------------
XXXXX-X--XXXXXXXXXXXXXXXX