-------------------------
-------------------------
-------------------------
-------------------------
-------------------------
-------------------------
-------------------------
-------------------------
-----E------?---------XSS
----<>---------------XXX-
----[]--------------XXXX-
----[]-------------XXXXX-
----[]------------XXXXXX-
XXXXXX---XXXXXXXXXXXXXX--