-------------------------
-------------------------
-------------------------
-------------------------
-------------------------
-------------------------
-------------------------
-------------------------
-------------------------
----------------XSS------
-----------E-E--X--------
----------<><>--X------B-
EEE---X---[][]-EX------b-
XXXXXXXXXXXXXXXXXXXXXXXXX