-------------------------
-------------------------
---------?---------------
-------------------------
-------------------------
------------------XXXX---
-----------SS----XXXXX---
----------------XXXXXX---
------SSS------XXXXXXX---
--------------XXXXXXXX---
----E--------XXXXXXXXX---
---<>-------XXXXXXXXXX---
---[]------XXXXXXXXXXX---
XXXXXXXXXX-XXXXXXXXXXXXXX