-------------------------
-------------------------
-------------------------
-------------------------
-------------------------
-------------------------
-------------------------
-------------------------
-------------------------
--------------------X----
-----E---E----------XX---
--------<>----------XXX--
--------[]----------XXXX-
XXXXXXXXXXXXXXXXXX--XXXXX