-------------------------
-------------------------
-------------------------
-------------------------
-------------------------
-------------------------
-------------------------
-------------------------
----------XSS-SQ---------
---------XXX-------------
--------XXXX-------------
-------XXXXX-------------
------XXXXXX--SSSSS------
XXXXXXXXXXX-------XX-XXXX