-------------------------
-------------------------
-------------------------
-------------------------
--E----------------------
SSSSSS-------------------
-------------------------
--------------------oo---
-------------------------
----------------XXX------
----------------XXX------
--------------X-XXX------
--------------X-XXX------
XXXXX-X--XXXX-X-XX---XXXX