-------------------------
-------------------------
-------------------------
-------------------------
-------------------------
-------------------------
-------------------------
-------------------------
-----------------Q-----E-
-----X----------E-----<>-
-----XX---------E-----[]-
-----XXX--------------[]-
-----XXXX-------------[]-
XXX--XXXXXXXXXXXXXXXXXXXX