-------------------------
-------------------------
-------------------------
-------------------------
-------------------------
----XX----S--------------
----XX-------------------
-XX-XX-------------------
-XX-XX--------------E----
-XX-XX----S--------<>----
XXX-XX-------------[]----
XXX-XX-------------[]----
XXX-XX-------------[]----
XXX-XXXXXXXXX--XXXXXXXXXX