-------------------------
-------------------------
-------------------------
-------------------------
-------------------------
-------------------------
-------------------------
-------------------------
------------o------------
-Q---------------E--QQ---
---------X------<>-------
---------X------[]-------
---------X------[]-------
XXXXXXXXXX------XXXXXXXXX