-------------------------
-------------------------
-------------------------
-------------------------
-------------------------
-?SS----------XX---------
-------------XXX---------
------------XXXX---------
-----------XXXXX---------
----------XXXXXX---------
--B------XXXXXXX---------
--b-----XXXXXXXX---------
--B----XXXXXXXXX--EE---EE
XXXXXXXXXXXXXXXXXXXXXXXXX