-------------------------
-------------------------
-------------------------
-------------------------
-------------------------
-?-----------------------
-------------------------
-------------------------
----------------o--------
-Q-----------------------
-----E-------------------
----<>-------------------
----[]--------------E-E-E
XXXXXXXXXXXXXXXXXXXXXXXXX