-------------------------
-------------------------
-------------------------
-------------------------
-------------------------
-----------------S------S
-------------------------
-------------------------
-------------------------
-----------------S-------
------------------------<
------------------------[
E---E--------E-E--------[
XXXXXXXXXXXXXXXXXXXX-XXXX