-------------------------
-------------------------
-------------------------
-------------------------
-------------------------
--------------------SSSSS
-------------------------
-------------------------
-------------oo----------
--Q----------------SSSSSS
-------------------------
-------------------------
---------XX--------------
XXXXXXXXXXXXXXXXXXXXXXXXX