-------------------------
-------------------------
-------------------------
-------------------------
-------------------------
-------------------------
-------------------------
-------------------------
-------------------------
-------------------------
----------X--------------
----------X--------------
---E-E----X--E-E-E-E-----
XXXXXXXX--XXXXXXXXXXXXXXX