-------------------------
-------------------------
-------------------------
-------------------------
-------------------------
-------------------------
-------------------------
-------------------------
-------------------------
-----------------------XX
-----------------------XX
-----------------------XX
-----------------------XX
XXXXXXX--X-XXXXXXXXXX--XX