-------------------------
-------------------------
-------------------------
-------------------------
-------------------------
-------------------------
-------------------------
-------------------------
-------E----E------------
------<>---<>--X---------
------[]---[]--XX--------
------[]---[]--XXX---B---
--EE--[]-E-[]--XXXX--b---
XXXXXXXXXXXXXXXXXXXXXXXXX