-------------------------
-------------------------
-------------------------
-------------------------
-------------------------
-------------------------
-------------------------
-------------------------
-------------------------
--------------SSS--------
------------------------E
-------------------------
-------------------------
XXXXXXXXXXXXXXXXXXXXXXXXX