-------------------------
-------------------------
-------------------------
-------------------------
-------------------------
-----------------XXXX----
----------------XXXXX----
---------------EXXXXX----
--------------XXXXXXX----
-E-----------XXXXXXXX----
<>---B-----EXXXXXXXXX----
[]---b-----XXXXXXXXXX----
[]---B----XXXXXXXXXXX----
XXXXXXXXXXXXXXXXXXXXXXXXX