-------------------------
-------------------------
-------------------------
-------------------------
-------------------------
-------------------------
-------------------------
-------------------------
----E------------o-------
---<>----------E---------
---[]---------<>---------
---[]---------[]---------
---[]-----XX--[]---------
XXXXXXXXXXXXXXXXXXXXXXXXX