-------------------------
-------------------------
-------------------------
-------------------------
-------------------------
-------------------------
-------------------------
--------XX---------------
-------XXX---------------
Q-----XXXX---------------
-----XXXXX---------------
----XXXXXX---------------
---XXXXXXX---------------
XXXXXXXXX--XXXXXXXXXXXXXX