-------------------------
-------------------------
-------------------------
-------------------------
-------------------------
-------------------------
-------------------------
-------------------------
----oo-----------o-------
------------------------E
-----------------------<>
---------B-------------[]
---------b-------------[]
X------XXXXXXXXXXXXXXXXXX