-------------------------
-------------------------
-------------------------
-------------------------
-------------------------
----S--------------------
-------------------------
-------------------------
-------------------------
SSS---------------E------
-----E-----------<>------
----<>-----------[]------
----[]-----------[]------
XXXXXXXXXXXXXXXXXXXXXXXXX