-------------------------
-------------------------
-------------------------
-------------------------
-------------------------
-------------------------
-------------------------
-------------------------
---------Q---------------
------Q-E------------E---
--------E-----------<>---
--------------------[]---
--------------------[]---
XXXXXXXXXXXXXXXXXX-XXXXXX