-------------------------
-------------------------
-------------------------
-------------------------
-------------------------
-----?SS---------------XX
----------------------XXX
---------------------EXXX
--------------------XXXXX
--E-------ESS------XXXXXX
-<>---B-----------XXXXXXX
-[]---b----------XXXXXXXX
-[]---B---------XXXXXXXXX
XXXXXXXXXXXXXXXXXXXXXXXXX