-------------------------
-------------------------
-------------------------
-------------------------
-------------------------
------------------SS-----
-------------------------
-------------------------
--------------SSSS-------
Q------------------------
------------E------------
-----------<>------------
------EE---[]------------
XXXXXXXXXXXXXXXXXXX-X-XXX