-------------------------
-------------------------
-------------------------
-------------------------
-------------------------
-----SSSS---SSS----------
-------------------------
-------------------------
------E-----------------o
----SSSSS--XXXXX---------
-----------X-------------
-----------X-------------
-----------X-------------
XX--XXXXXXXXXX----X------