-------------------------
-------------------------
-------------------------
-------------------------
-------------------------
-------------------------
-------------------------
-------------------------
-------------------------
------------SS-----------
-------------------------
-------------------------
--EEE-EE-E------EE-E-E-E-
XXXXXXXXXXXXXXXXXXXXXXXXX