-------------------------
-------------------------
-------------------------
-------------------------
-------------------------
--------------Q----------
-------------------------
-------------------------
--E-------E--------------
-<>------<>---?----------
-[]--E---[]-------------X
-[]-<>---[]----------XXXX
-[]-[]---[]---------XXXXX
XXXXXXXXXXXXXXXXXXXXXXX--