-------------------------
-------------------------
-------------------------
-------------------------
-------------------------
----------------SSS------
-------------------------
-------------------------
-------------------------
---------------XXXXX-----
E--------------X---------
---------------X---------
---------------X---------
XXXXXXXXXXXXXXXXXX-----XX