-------------------------
-------------------------
-------------------------
-------------------------
-------------------------
----------------------XX-
---------------------XXX-
--------------------EXXX-
------oo-----------XXXXX-
------------------XXXXXX-
-----------------XXXXXXX-
----------------XXXXXXXX-
------------E--XXXXXXXXX-
XXXXXXXXXXXXXXXXXXXXXXXXX