-------------------------
-------------------------
-------------------------
-------------------------
-------------------------
----------------S--------
-------------------------
------------X------------
------------X--E-EE------
-E-------XX-X------XX-X--
<>------XXX-X------XX-X--
[]-----XXXX-X------XX-X--
[]----XXXXX-X------X--X--
XXXXXXXXXXX-X------X--X--