-------------------------
-------------------------
-------------------------
-------------------------
-------------------------
-------------------------
-------------------------
-------------------------
-S-------S---------------
------------E------------
------E----<>------------
-----------[]------------
-----------[]-E---------X
XXXXXXXXXXXXXXXX-XXXXXXXX