-------------------------
-------------------------
-------------------------
-------------------------
-------------------------
----------------SSS------
-------------------------
-------------------------
-------------------------
-------------E-XXXXX-----
------------<>-X---------
------------[]-X---------
------EE-E--[]-X---------
XXXXXXXXXXXXXXXXXX----XXX