-------------------------
-------------------------
-------------------------
-------------------------
-------------------------
-------------------------
-------------------------
-------------------------
-------------------------
------E-X--------E-------
-----<>-XX-----E<>-------
-----[]-XXX---<>[]-------
-----[]-XXXX--[][]-EE----
XXXXXXXXXXXXXXXXXXXXXXXXX