-------------------------
-------------------------
-------------------------
-------------------------
----------------------oo-
-------------------------
-------------------------
-------------------------
-------------------------
--------------XX---------
-------------XXX---------
------E-----XXXXX--------
--X--------XXXXXX--EE-EE-
XXXXX-X-XXXXXXXXXXXXXXXXX