-------------------------
-------------------------
-------------------------
-------------------------
-------------------------
----SSSS---SQQS----------
-------------------------
---E---------------------
-------------------------
-S?S--------SS-----------
-------------------------
--------------------B---<
----------E-E-------b---[
XXXXXX---XXXXXXXXXXXXXXXX