-------------------------
-------------------------
-------------------------
-------------------------
-------------------------
----------------SSSSS----
-------------------------
-------------------------
----------------SSSSS----
-E--------E-------------E
<>------E<>------------<>
[]-----<>[]------------[]
[]-----[][]------------[]
XXXXXXXXXXXXXXX------XXXX