-------------------------
-------------------------
-------------------------
-------------------------
-------------------------
-----Q-Q-----------SSSSS-
-------------------------
-------------------------
-------------------------
-----Q-Q------------S----
----------------------E--
----------X--------------
----------X-EE-----------
XXXXXXXXXXXXXXXXXXXXXXXXX