-------------------------
-------------------------
-------------------------
-------------------------
-------------------------
----SSSSSS---------------
-------------------------
------------------X------
-----E------------X---E--
---SSSSSSSS-----X-X--<>--
----------------X-X--[]--
--------------X-X-X--[]--
--------------X-X-X--[]--
X--XXXXXXXXXX-X-X-X--XXXX