-------------------------
-------------------------
-------------------------
-------------------------
-------------------------
-----------SSSSS---SSSSS-
-------------------------
-------------------------
-------------------------
------------S----XX----ES
--------------E--XX---<>-
-----------------XXX--[]-
-----------------XXX--[]-
XXXXX-XXXXXXXXXXXXXXXXXXX