-------------------------
-------------------------
-------------------------
-------------------------
-------------------------
---------------------E---
-------------------------
-----------------------X-
---E-----------------EXX-
--<>----------------<>XX-
--[]-----X----------[]XX-
--[]-----X---------X[]XX-
--[]-E---X--------XX[]XX-
XXXXXXXXXX---XXXXXXXXXXXX