-------------------------
-------------------------
-------------------------
-------------------------
-------------------------
-S---------------------SS
-------------------------
-------------------------
----o--------------------
--E----------------------
-<>----------------------
-[]----------------------
-[]----------------------
XXXXXXXXXXXXXXXXXXXXXXXXX