-------------------------
-------------------------
-------------------------
-------------------------
----------E--------------
--------SSSS-------------
-------------------------
-------------------------
-------------------------
--------SSSS------------E
-----------------------<>
--------------B--------[]
-----E--------b--------[]
XXXXXXXXXXXXXXXXXXXXXXXXX