-------------------------
-------------------------
-------------------------
-------------------------
-------------------------
-------------------------
-------------------------
-------------------------
---------E---------------
-------E<>-----<>-----E--
------<>[]-----[]----<>--
------[][]-----[]----[]--
------[][]-----[]----[]--
X--XXXXXXXXXXXXXXXXXXXXXX