-------------------------
-------------------------
-------------------------
-------------------------
----------------------oo-
-------------------------
-------------------------
-------------------------
-------E-----------------
-----E<>--<>-------------
---E<>[]--[]-------------
--<>[][]--[]-------------
--[][][]--[]-------EE-EE-
XXXXXXXXXXXXXXXXXXXXXXXXX