-------------------------
-------------------------
-------------------------
-------------------------
-------------------------
-----------XX------------
-----------XX------------
---------X-XX------------
---------X-XX------------
----E-XX-X-XX------E-----
---<>-XX-X-XX-----<>-----
---[]-XX-X-XX-----[]-----
---[]-XX-X-XX-----[]--X--
XXXXXXXX-X-XXXXXXXXXXXXXX