-------------------------
-------------------------
-------------------------
-------------------------
-------------------------
-------------------------
----------------E--------
--B------------<>------XX
--b---------E--[]------XX
SSXSS------<>--XXX-----XX
-----------[]---------XXX
-----------[]---------XXX
-------E---[]---------XXX
XXXXXXXXXXXXXXXXXXXXXXXXX