-------------------------
-------------------------
-------------------------
-------------------------
-------------------------
-------------------------
-------------------------
--------------------X----
------o------------XX----
------------------XXX----
-----------------XXXX----
----------------XXXXX----
---------------XXXXXX----
XXX-----X-XXXXXXXXXXXXXXX