-------------------------
-------------------------
-------------------------
-------------------------
-------------------------
-------------------------
-------------------------
-------------------------
-------------------------
-------------------------
--<>---------------------
--[]------------------E--
--[]-E-EE-----EE-E-------
XXXXXXXXXXXXXXXXXXXXX-X-X