-------------------------
-------------------------
-------------------------
-------------------------
-------------------------
---------------------XX--
--------------------XXX--
-------------------XXXX--
------------------XXXXX--
-----E-----------XXXXXX--
----<>----------XXXXXXX--
----[]---------XXXXXXXX--
----[]--------XXXXXXXXX--
XXXXXXXXXXXXXXXXXXXXXXXXX