-------------------------
-------------------------
-------------------------
-------------------------
-------------------------
------------------SS-----
-------------------------
-------------------------
-------------------------
-----------------XXXX----
---E----------XXXXX------
--------<>-XXXXXX--------
--------[]XXXXX----------
XXXXXXXXXXXXX------XX--X-