-------------------------
-------------------------
-------------------------
-------------------------
-------------------------
-------------------------
-------------------------
-------------------------
-----------E-------------
----------<>-------------
----------[]----E--------
----------[]---<>--------
----------[]---[]--------
XXXXXXXXXXXXXXXXXXXXXXXXX