-------------------------
-------------------------
-------------------------
-------------------------
-------------------------
--------------------SSSSS
-------------------------
-------------------------
-----------------SSS-----
-------------------------
--E----------------------
------B------------------
------b------E-----------
XXXXXXXXX-XXXXXXXXXXX----